10 02 10 11 10 11 00 10 10 10 
10 02 10 11 10 11 00 10 10 10 
10 02 10 11 10 11 00 10 10 10 
10 10 10 12 02 12 10 10 10 10 
   10 10 02 02 02 10 10 10 
      10 00 00 10 10 10 
         10 00 00 10 
58